NO ./resources/colorstone.xpm   
     
    SO ./resources/bluestone.xpm  
  
WE ./resources/purplestone.xpm 
EA ./resources/redbrick.xpm

C 200,230,255
  
F 80,60,30

1111111111111
11          1
 1    N      1
11          1                       
1111111111111
