NO ./resources/colorstone.xpm
SO ./resources/bluestone.xpm
WE ./resources/purplestone.xpm
EA ./resources/redbrick.xpm

C 200,230,255   
F 80,60,30

11111111
10000001
10000001
10000001
10000001
10000001
100N0001
11111111
