NO ./resources/supawall5.xpm
SO ./resources/supawall.xpm
WE ./resources/supawall3.xpm
EA ./resources/supawall4.xpm

C       25 ,     25,           112   
F 158,23,17

        1111111111111111111111111
        1000000000100000000000001
        1011000000100000010000001
        1011000000100000010000001
        1011000000100000010000001
        1011000000100000010000001
        101100S000100000010000001
        1011000000100000010000001
        1001000000000011110111111
1111111110110000011100000001
100000000011000001110011111111111
1000000000111101110000001
11111111111111011101001011111
11111111110101011100000010001
10000000000000001100000010001
10000000000000001101010010001
11000001110101011111011110011
11111111 1110101 101111010001
11111111 1111111 111111111111
